...............
...............
..12121212121..
...121232121...
....1234321....
.....12321.....
......121......
.......1.......
...............
...............
...............
...............
...............
...............
...............
...............
...............
...............
...............
...............
...............
...............
...............
...............
...............
...............
...............
...............
...............
...............
