.......1.......
......131......
.....11311.....
..11111311111..
.....11311.....
......131......
.......3.......
.....22.22.....
....22...22....
...22.....22...
..22.......22..
...............
...............
...............
...............
...............
...............
...............
...............
...............
...............
...............
...............
...............
...............
...............
...............
...............
...............
...............
