...............
.....22322.....
.......1.......
.......1.......
.......1.......
.......1.......
......111......
..22222222222..
..3.3.3.3.3.3..
.3.3.3.3.3.3.3.
...............
...............
...............
...............
...............
...............
...............
...............
...............
...............
...............
...............
...............
...............
...............
...............
...............
...............
...............
...............
