###############
#             #
# 12121212121 #
#  121212121  #
#   1213121   #
#    12121    #
#     121     #
#      1      #
#             #
#             #
#             #
#             #
#             #
#             #
#             #
#             #
#             #
#             #
#             #
#             #
#             #
#             #
#             #
#             #
#             #
#             #
#             #
#             #
#             #
###############